S # # # # # S # # # # # S 
                          
  ==========  ==========  
                          
                          
  ====  ==========  ====  
        0##-##-  0        
        0##-##-  0        
======--0##=##=  0  ==--==
###########=##=  -  ######
###########=##=  -  ######
--==========##============
           =              
           =              
000000000--=  ===0000000--
           =  =###########
           =  =###########
--0000--====  =--000000000
              =  /////////
              =  /////////
===  ====  ====  =======//
     =P =        =P =     
     =  =        =  =     
           ----           
           -H -           
           -  -           